






			    __                   __   ______                      __     __     
			   / /   ___ _   _____  / /  / ____/___  ____ ___  ____  / /__  / /____ 
			  / /   / _ \ | / / _ \/ /  / /   / __ \/ __ `__ \/ __ \/ / _ \/ __/ _ \
			 / /___/  __/ |/ /  __/ /  / /___/ /_/ / / / / / / /_/ / /  __/ /_/  __/
			/_____/\___/|___/\___/_/   \____/\____/_/ /_/ /_/ .___/_/\___/\__/\___/ 
			                                               /_/                      